public static let Aliceblue = Color(hex:AdditionalColors.aliceblue.rawValue)
public static let Antiquewhite = Color(hex:AdditionalColors.antiquewhite.rawValue)
public static let Aqua = Color(hex:AdditionalColors.aqua.rawValue)
public static let Aquamarine = Color(hex:AdditionalColors.aquamarine.rawValue)
public static let Azure = Color(hex:AdditionalColors.azure.rawValue)
public static let Beige = Color(hex:AdditionalColors.beige.rawValue)
public static let Bisque = Color(hex:AdditionalColors.bisque.rawValue)
public static let Black = Color(hex:AdditionalColors.black.rawValue)
public static let Blanchedalmond = Color(hex:AdditionalColors.blanchedalmond.rawValue)
public static let Blue = Color(hex:AdditionalColors.blue.rawValue)
public static let Blueviolet = Color(hex:AdditionalColors.blueviolet.rawValue)
public static let Brown = Color(hex:AdditionalColors.brown.rawValue)
public static let Burlywood = Color(hex:AdditionalColors.burlywood.rawValue)
public static let Cadetblue = Color(hex:AdditionalColors.cadetblue.rawValue)
public static let Chartreuse = Color(hex:AdditionalColors.chartreuse.rawValue)
public static let Chocolate = Color(hex:AdditionalColors.chocolate.rawValue)
public static let Coral = Color(hex:AdditionalColors.coral.rawValue)
public static let Cornflowerblue = Color(hex:AdditionalColors.cornflowerblue.rawValue)
public static let Cornsilk = Color(hex:AdditionalColors.cornsilk.rawValue)
public static let Crimson = Color(hex:AdditionalColors.crimson.rawValue)
public static let Cyan = Color(hex:AdditionalColors.cyan.rawValue)
public static let Darkblue = Color(hex:AdditionalColors.darkblue.rawValue)
public static let Darkcyan = Color(hex:AdditionalColors.darkcyan.rawValue)
public static let Darkgoldenrod = Color(hex:AdditionalColors.darkgoldenrod.rawValue)
public static let Darkgray = Color(hex:AdditionalColors.darkgray.rawValue)
public static let Darkgreen = Color(hex:AdditionalColors.darkgreen.rawValue)
public static let Darkgrey = Color(hex:AdditionalColors.darkgrey.rawValue)
public static let Darkkhaki = Color(hex:AdditionalColors.darkkhaki.rawValue)
public static let Darkmagenta = Color(hex:AdditionalColors.darkmagenta.rawValue)
public static let Darkolivegreen = Color(hex:AdditionalColors.darkolivegreen.rawValue)
public static let Darkorange = Color(hex:AdditionalColors.darkorange.rawValue)
public static let Darkorchid = Color(hex:AdditionalColors.darkorchid.rawValue)
public static let Darkred = Color(hex:AdditionalColors.darkred.rawValue)
public static let Darksalmon = Color(hex:AdditionalColors.darksalmon.rawValue)
public static let Darkseagreen = Color(hex:AdditionalColors.darkseagreen.rawValue)
public static let Darkslateblue = Color(hex:AdditionalColors.darkslateblue.rawValue)
public static let Darkslategray = Color(hex:AdditionalColors.darkslategray.rawValue)
public static let Darkslategrey = Color(hex:AdditionalColors.darkslategrey.rawValue)
public static let Darkturquoise = Color(hex:AdditionalColors.darkturquoise.rawValue)
public static let Darkviolet = Color(hex:AdditionalColors.darkviolet.rawValue)
public static let Deeppink = Color(hex:AdditionalColors.deeppink.rawValue)
public static let Deepskyblue = Color(hex:AdditionalColors.deepskyblue.rawValue)
public static let Dimgray = Color(hex:AdditionalColors.dimgray.rawValue)
public static let Dimgrey = Color(hex:AdditionalColors.dimgrey.rawValue)
public static let Dodgerblue = Color(hex:AdditionalColors.dodgerblue.rawValue)
public static let Firebrick = Color(hex:AdditionalColors.firebrick.rawValue)
public static let Floralwhite = Color(hex:AdditionalColors.floralwhite.rawValue)
public static let Forestgreen = Color(hex:AdditionalColors.forestgreen.rawValue)
public static let Fuchsia = Color(hex:AdditionalColors.fuchsia.rawValue)
public static let Gainsboro = Color(hex:AdditionalColors.gainsboro.rawValue)
public static let Ghostwhite = Color(hex:AdditionalColors.ghostwhite.rawValue)
public static let Gold = Color(hex:AdditionalColors.gold.rawValue)
public static let Goldenrod = Color(hex:AdditionalColors.goldenrod.rawValue)
public static let Gray = Color(hex:AdditionalColors.gray.rawValue)
public static let Green = Color(hex:AdditionalColors.green.rawValue)
public static let Greenyellow = Color(hex:AdditionalColors.greenyellow.rawValue)
public static let Grey = Color(hex:AdditionalColors.grey.rawValue)
public static let Honeydew = Color(hex:AdditionalColors.honeydew.rawValue)
public static let Hotpink = Color(hex:AdditionalColors.hotpink.rawValue)
public static let Indianred = Color(hex:AdditionalColors.indianred.rawValue)
public static let Indigo = Color(hex:AdditionalColors.indigo.rawValue)
public static let Ivory = Color(hex:AdditionalColors.ivory.rawValue)
public static let Khaki = Color(hex:AdditionalColors.khaki.rawValue)
public static let Lavender = Color(hex:AdditionalColors.lavender.rawValue)
public static let Lavenderblush = Color(hex:AdditionalColors.lavenderblush.rawValue)
public static let Lawngreen = Color(hex:AdditionalColors.lawngreen.rawValue)
public static let Lemonchiffon = Color(hex:AdditionalColors.lemonchiffon.rawValue)
public static let Lightblue = Color(hex:AdditionalColors.lightblue.rawValue)
public static let Lightcoral = Color(hex:AdditionalColors.lightcoral.rawValue)
public static let Lightcyan = Color(hex:AdditionalColors.lightcyan.rawValue)
public static let Lightgoldenrodyellow = Color(hex:AdditionalColors.lightgoldenrodyellow.rawValue)
public static let Lightgray = Color(hex:AdditionalColors.lightgray.rawValue)
public static let Lightgreen = Color(hex:AdditionalColors.lightgreen.rawValue)
public static let Lightgrey = Color(hex:AdditionalColors.lightgrey.rawValue)
public static let Lightpink = Color(hex:AdditionalColors.lightpink.rawValue)
public static let Lightsalmon = Color(hex:AdditionalColors.lightsalmon.rawValue)
public static let Lightseagreen = Color(hex:AdditionalColors.lightseagreen.rawValue)
public static let Lightskyblue = Color(hex:AdditionalColors.lightskyblue.rawValue)
public static let Lightslategray = Color(hex:AdditionalColors.lightslategray.rawValue)
public static let Lightslategrey = Color(hex:AdditionalColors.lightslategrey.rawValue)
public static let Lightsteelblue = Color(hex:AdditionalColors.lightsteelblue.rawValue)
public static let Lightyellow = Color(hex:AdditionalColors.lightyellow.rawValue)
public static let Lime = Color(hex:AdditionalColors.lime.rawValue)
public static let Limegreen = Color(hex:AdditionalColors.limegreen.rawValue)
public static let Linen = Color(hex:AdditionalColors.linen.rawValue)
public static let Magenta = Color(hex:AdditionalColors.magenta.rawValue)
public static let Maroon = Color(hex:AdditionalColors.maroon.rawValue)
public static let Mediumaquamarine = Color(hex:AdditionalColors.mediumaquamarine.rawValue)
public static let Mediumblue = Color(hex:AdditionalColors.mediumblue.rawValue)
public static let Mediumorchid = Color(hex:AdditionalColors.mediumorchid.rawValue)
public static let Mediumpurple = Color(hex:AdditionalColors.mediumpurple.rawValue)
public static let Mediumseagreen = Color(hex:AdditionalColors.mediumseagreen.rawValue)
public static let Mediumslateblue = Color(hex:AdditionalColors.mediumslateblue.rawValue)
public static let Mediumspringgreen = Color(hex:AdditionalColors.mediumspringgreen.rawValue)
public static let Mediumturquoise = Color(hex:AdditionalColors.mediumturquoise.rawValue)
public static let Mediumvioletred = Color(hex:AdditionalColors.mediumvioletred.rawValue)
public static let Midnightblue = Color(hex:AdditionalColors.midnightblue.rawValue)
public static let Mintcream = Color(hex:AdditionalColors.mintcream.rawValue)
public static let Mistyrose = Color(hex:AdditionalColors.mistyrose.rawValue)
public static let Moccasin = Color(hex:AdditionalColors.moccasin.rawValue)
public static let Navajowhite = Color(hex:AdditionalColors.navajowhite.rawValue)
public static let Navy = Color(hex:AdditionalColors.navy.rawValue)
public static let Oldlace = Color(hex:AdditionalColors.oldlace.rawValue)
public static let Olive = Color(hex:AdditionalColors.olive.rawValue)
public static let Olivedrab = Color(hex:AdditionalColors.olivedrab.rawValue)
public static let Orange = Color(hex:AdditionalColors.orange.rawValue)
public static let Orangered = Color(hex:AdditionalColors.orangered.rawValue)
public static let Orchid = Color(hex:AdditionalColors.orchid.rawValue)
public static let Palegoldenrod = Color(hex:AdditionalColors.palegoldenrod.rawValue)
public static let Palegreen = Color(hex:AdditionalColors.palegreen.rawValue)
public static let Paleturquoise = Color(hex:AdditionalColors.paleturquoise.rawValue)
public static let Palevioletred = Color(hex:AdditionalColors.palevioletred.rawValue)
public static let Papayawhip = Color(hex:AdditionalColors.papayawhip.rawValue)
public static let Peachpuff = Color(hex:AdditionalColors.peachpuff.rawValue)
public static let Peru = Color(hex:AdditionalColors.peru.rawValue)
public static let Pink = Color(hex:AdditionalColors.pink.rawValue)
public static let Plum = Color(hex:AdditionalColors.plum.rawValue)
public static let Powderblue = Color(hex:AdditionalColors.powderblue.rawValue)
public static let Purple = Color(hex:AdditionalColors.purple.rawValue)
public static let Rebeccapurple = Color(hex:AdditionalColors.rebeccapurple.rawValue)
public static let Red = Color(hex:AdditionalColors.red.rawValue)
public static let Rosybrown = Color(hex:AdditionalColors.rosybrown.rawValue)
public static let Royalblue = Color(hex:AdditionalColors.royalblue.rawValue)
public static let Saddlebrown = Color(hex:AdditionalColors.saddlebrown.rawValue)
public static let Salmon = Color(hex:AdditionalColors.salmon.rawValue)
public static let Sandybrown = Color(hex:AdditionalColors.sandybrown.rawValue)
public static let Seagreen = Color(hex:AdditionalColors.seagreen.rawValue)
public static let Seashell = Color(hex:AdditionalColors.seashell.rawValue)
public static let Sienna = Color(hex:AdditionalColors.sienna.rawValue)
public static let Silver = Color(hex:AdditionalColors.silver.rawValue)
public static let Skyblue = Color(hex:AdditionalColors.skyblue.rawValue)
public static let Slateblue = Color(hex:AdditionalColors.slateblue.rawValue)
public static let Slategray = Color(hex:AdditionalColors.slategray.rawValue)
public static let Slategrey = Color(hex:AdditionalColors.slategrey.rawValue)
public static let Snow = Color(hex:AdditionalColors.snow.rawValue)
public static let Springgreen = Color(hex:AdditionalColors.springgreen.rawValue)
public static let Steelblue = Color(hex:AdditionalColors.steelblue.rawValue)
public static let Tan = Color(hex:AdditionalColors.tan.rawValue)
public static let Teal = Color(hex:AdditionalColors.teal.rawValue)
public static let Thistle = Color(hex:AdditionalColors.thistle.rawValue)
public static let Tomato = Color(hex:AdditionalColors.tomato.rawValue)
public static let Turquoise = Color(hex:AdditionalColors.turquoise.rawValue)
public static let Violet = Color(hex:AdditionalColors.violet.rawValue)
public static let Wheat = Color(hex:AdditionalColors.wheat.rawValue)
public static let White = Color(hex:AdditionalColors.white.rawValue)
public static let Whitesmoke = Color(hex:AdditionalColors.whitesmoke.rawValue)
public static let Yellow = Color(hex:AdditionalColors.yellow.rawValue)
public static let Yellowgreen = Color(hex:AdditionalColors.yellowgreen.rawValue)
